# IMMC

OCC = "countries/Occitania.txt"
SOV = "countries/Soviet Union.txt"
SAX = "countries/Saxony.txt"
BRI = "countries/Britannia.txt"
BAY = "countries/Baytika.txt"
ALP = "countries/Alpbania.txt"
RUM = "countries/Rum.txt"
ILL = "countries/Illyria.txt"
CNN = "countries/Canaan.txt"
RST = "countries/RaST.txt"
NAT = "countries/New Athens.txt"
HAB = "countries/Habesha.txt"
DAM = "countries/Dampost.txt"
KHO = "countries/Khorezm.txt"
KES = "countries/Keshigia.txt"
TOL = "countries/Toledo.txt"
RAT = "countries/Raetia.txt"
MAI = "countries/Mainz.txt"
NBL = "countries/New Belgium.txt"
MRV = "countries/Maravi.txt"
UAE = "countries/Ad.txt"
RSC = "countries/RESEC.txt"
AEG = "countries/Aegyptos.txt"
LIP = "countries/Liptozsentmiklos.txt"
HRE = "countries/Holy Roman Empire.txt"
THR = "countries/Thrace.txt"
POL = "countries/Poland.txt"
MGS = "countries/Magisterium.txt"
CRT = "countries/Courtyard.txt"
SUO = "countries/Suomi.txt"
UKR = "countries/Ukraine.txt"
LIT = "countries/Lithuania.txt"
USA = "countries/United States of America.txt"
ROM = "countries/Moldovia.txt"
BLR = "countries/Belarus.txt"
KUR = "countries/Kurdistan.txt"
TAT = "countries/Tartaria.txt"
KAZ = "countries/Kazakhstan.txt"
NDG = "countries/Ndongo.txt"
MZV = "countries/Mazovia.txt"
NSJ = "countries/Nusajaya.txt"
JAP = "countries/Kabanoki.txt"
NZL = "countries/Ennor.txt"
GBR = "countries/GBR.txt"
PNJ = "countries/Punjab.txt"
GNY = "countries/Gunyi.txt"
MAD = "countries/Lemuria.txt"
ZZZ = "countries/The Anarchy.txt"

GRY = "countries/Grey Wolves.txt"
SLC = "countries/SILC.txt"
MTB = "countries/Al Mutabein.txt"
PRF = "countries/People's Revolutionary Front.txt"
SAR = "countries/Soviet Army in Rum.txt"